0 0 0 0 0 0 0 0 0 0 0 0 0 0 0 0
0 0 10 11 0 0 0 0 0 0 0 0 10 11 0 0
0 0 4 0 0 0 0 10 11 0 0 0 0 0 0 0
0 0 10 11 0 0 0 0 0 10 11 0 0 0 0 0
0 0 0 0 0 0 0 0 0 0 0 0 0 0 0 0
0 0 0 0 0 0 0 10 11 0 0 0 0 0 0 0
3 0 0 0 0 0 0 3 0 0 0 0 0 0 0 0
0 10 11 0 0 0 3 3 0 0 0 0 0 0 0 0
0 0 0 0 0 3 0 0 0 0 0 0 0 0 0 0
0 0 0 0 3 0 0 0 3 15 0 0 12 13 0 0
1 1 1 1 4 5 5 5 4 1 1 1 1 1 1 1
2 2 2 2 4 4 4 4 4 2 2 2 2 2 2 2
